++++++++++++++++++++++++
+aA                    +
+                      +
+                      +
+                      +
+        B     B       +
+        B  0  B       +
+        B  B  B       +
+                      +
+                      +
+                      +
++++++++++++++++++++++++