++++++++++++++++++++++++
+aA                    +
+                      +
+                      +
+                      +
+                      +
+        B  0  B       +
+           B          +
+                      +
+                      +
+                      +
++++++++++++++++++++++++